1;1;1;1;1;1;1;1;1;1
1;1;1;X;X;X;1;1;1;1
1;1;X;2;2;1;1;1;2;2
1;1;X;2;CC;1;1;1;CN;2
1;1;X;2;2;2;2;2;2;2
1;1;X;1;1;1;1;1;1;1
1;X;X;X;X;X;1;1;1;1
1;1;1;P;1;1;1;1;1;1
1;1;1;1;1;1;1;1;1;1
1;1;1;1;1;1;1;1;1;1